0
0
6 6 6 6 6 6 6 6 6 6 6 6 6 6 6 6
6 6 6 6 1 6 7 0 0 0 6 6 6 6 6 6
6 6 6 7 0 0 0 0 0 0 6 6 6 6 6 6
6 6 7 0 0 0 0 0 0 0 6 6 6 6 6 6
6 7 0 0 0 0 0 0 0 0 5 6 6 6 6 6
0 0 0 0 0 0 0 0 0 0 0 0 0 0 0 0
0 0 0 0 0 0 0 0 0 0 0 0 0 0 0 0
3 4 0 0 0 0 0 0 0 0 0 0 0 0 2 3
6 6 0 0 0 0 0 0 0 0 0 0 0 0 6 6
6 6 3 3 3 3 3 3 3 3 3 3 3 3 6 6
6 6 6 6 6 6 6 6 6 6 6 6 6 6 6 6
-1
0
6 6 6 6 6 6 6 6 6 6 6 6 6 6 6 6
6 7 0 0 0 0 0 0 0 0 0 0 0 0 6 6
6 0 0 0 0 0 0 0 8 0 0 0 0 0 6 6
6 0 0 0 0 0 0 0 0 0 0 0 0 0 6 6
6 0 0 0 0 0 0 0 0 0 0 8 0 0 5 6
6 0 8 0 0 8 0 0 8 0 0 0 0 0 0 0
6 0 0 0 0 0 0 0 0 0 0 8 0 0 0 0
6 0 0 0 0 0 0 0 0 0 0 0 0 0 2 3
6 0 0 0 0 0 0 0 8 0 0 0 0 2 6 6
6 4 0 0 0 0 0 0 0 0 0 0 2 6 6 6
6 6 3 3 3 3 3 3 3 3 3 3 6 6 6 6
1
0
6 6 9 6 6 6 9 6 6 9 6 6 9 6 6 9
6 6 9 0 0 0 9 0 0 9 0 0 9 0 0 9
6 6 0 0 0 0 0 0 0 0 0 0 0 0 0 9
6 6 0 0 0 0 0 0 0 0 0 0 0 0 0 9
6 7 0 0 9 0 0 0 0 9 0 0 9 0 0 0
0 0 0 0 0 0 0 0 0 0 0 0 0 0 0 0
0 0 0 0 0 0 0 0 0 0 0 0 0 0 0 0
4 0 0 0 0 0 0 0 0 0 0 0 0 0 0 0
6 4 0 0 0 0 0 0 0 0 0 0 0 0 0 0
6 6 9 9 9 9 9 9 9 9 9 9 9 9 9 9
6 6 9 9 9 9 9 9 9 9 9 9 9 9 9 9